____________________
_____----------_____
_____|........|_____
_____|........|_____
_____|........+##___
_____|........|_#___
_____----+-----_#___
_________#______#___
_________########___
____________________
